# Non-Players (Test or Colonizers)
 TES	= "countries/Test.txt"
 EUR = "countries/Europe.txt"
 ENG = "countries/United Kingdom.txt"
 HOL = "countries/Netherlands.txt"
 BEL = "countries/Belgium.txt"
 FRA = "countries/France.txt"
 SPR = "countries/Spain.txt"
 ITA = "countries/Italy.txt"
 AUS = "countries/Austria.txt"
 GER = "countries/Germany.txt"
 DEN = "countries/Denmark.txt"
 SWE = "countries/Sweden.txt"
 RUS = "countries/Russia.txt"
 USA = "countries/United States.txt"
 CSA = "countries/Confederated States.txt"
 BRA = "countries/Brazil.txt"
# Majors (Countries on Bookmark or has subjects)
 #OTO = "countries/Ottomans.txt"
 POR = "countries/Portugal.txt"
 #OMA = "countries/Oman.txt"
# Europe
 ALB = "countries/Albania.txt"
 GRE = "countries/Greece.txt"
 RUM = "countries/Rumelia.txt"
 CYP = "countries/Cyprus.txt"
# Upper Middle East
 #KUR = "countries/Kurdistan.txt"
 ABN = "countries/Arabistan.txt"
 PER = "countries/Persia.txt"
 #IRQ = "countries/Iraq.txt"
 #SYR = "countries/Syria.txt"
 #LEB = "countries/Lebanon.txt"
 #PAL = "countries/Palestine.txt"
 #JOR = "countries/Jordan.txt"
 #KUW = "countries/Kuwait.txt"
 KLT = "countries/Balouchistan.txt"
# Arabia
 HIL = "countries/Ha'il.txt"
 BHR = "countries/Bahrain.txt"
 QTR = "countries/Qatar.txt"
 #SAU = "countries/Saudi Arabia.txt"
 #HJZ = "countries/Hejaz.txt"
 AHB = "countries/Abu Dhabi.txt"
 DBI = "countries/Dubai.txt"
 SJH = "countries/Sharjah.txt"
 UMM = "countries/Umm al-Qaiwain.txt"
 RKH = "countries/Ras al-Khaimah.txt"
 AJM = "countries/Ajman.txt"
 FJR = "countries/Fujarah.txt"
 #MAH = "countries/Mahra.txt"
 #KAT = "countries/Kathira.txt"
 QTI = "countries/Qu'aiti.txt"
 #YEM = "countries/Yemen.txt"
 #ADN = "countries/Aden.txt"
 #ZAI = "countries/Zaidi.txt"
# Maghreb
 #EGY = "countries/Egypt.txt"
 #LBA = "countries/Libya.txt"
 #SNS = "countries/Senussi.txt"
 #TUN = "countries/Tunisia.txt"
 #ALG = "countries/Algeria.txt"
 #MOR = "countries/Morocco.txt"
 #ASS = "countries/Awlad Sidi Shaydkh.txt"
 #KAG = "countries/Kel Ahaggar.txt"
 SHW = "countries/Saharwi.txt"
 #MRT = "countries/Mauritania.txt"
 #ARR = "countries/Adrar.txt"
 #TRZ = "countries/Trarza.txt"
 #TGN = "countries/Tagant.txt"
 
 # North Africa/Middle East
	# graphical_culture = middle_eastern_gfx
	# graphical_culture_2d = middle_eastern_2d
	ADN = "countries/Aden.txt"
	ALG = "countries/Algeria.txt"
	ASS = "countries/Awlad Sidi Shaykh.txt"
	ASY = "countries/Assyria.txt"
	EGY = "countries/Egypt.txt"
	EPD = "countries/Etat Pied Noir.txt"
	ERZ = "countries/Israel.txt"
	HJZ = "countries/Hejaz.txt"
	IRQ = "countries/Iraq.txt"
	ISS = "countries/Muslium Caliphate.txt"
	JOR = "countries/Jordan.txt"
	JSH = "countries/Jebel Shammar.txt"
	KAG = "countries/Kel Ahaggar.txt"
	KAT = "countries/Kathiri.txt"
	KBY = "countries/Kabyles.txt"
	KUR = "countries/Kurdistan.txt"
	KUW = "countries/Kuwait.txt"
	LBA = "countries/Libya.txt"
	LEB = "countries/Lebanon.txt"
	MAH = "countries/Mahra.txt"
	MOR = "countries/Morocco.txt"
	NJD = "countries/Nejd.txt"
	OMA = "countries/Oman.txt"
	OTO = "countries/Ottomans.txt"
	PAL = "countries/Palestine.txt"
	QUA = "countries/Quaiti.txt"
	SAU = "countries/Saudi Arabia.txt"
	SNS = "countries/Senussi.txt"
	SYR = "countries/Syria.txt"
	TCS = "countries/Trucial States.txt"
	TUN = "countries/Tunisia.txt"
	TUR = "countries/Turkey.txt"
	WES = "countries/Western Sahara.txt"
	YEM = "countries/Yeman.txt"

# West Africa
	# graphical_culture = african_gfx
	# graphical_culture_2d = african_2d
	#Matuania
	ARR = "countries/Adrar.txt"
	BRN = "countries/Brakna.txt"
	TRZ = "countries/Trarza.txt"
	#Senegal
	BAO = "countries/Baol.txt"
	SNG = "countries/Senegal.txt"
	#Mali
	
	#guinea
	
	#serra leone-liberia
	LIB = "countries/Liberia.txt"
	KOY = "countries/Koya Temne.txt"
	KRU = "countries/Kru.txt"
	MND = "countries/Mande.txt"
	#Ivory coast
	AKA = "countries/Akan.txt"
	KOG = "countries/Kong.txt"
	#ghana-burkino faso-togo-benin
	GDC = "countries/Gold Coast.txt"
	#nigeria-niger
	DAH = "countries/Dahomey.txt"
	TUG = "countries/Tuareg.txt"
	KBO = "countries/Kanem-Bornu.txt"
        DMG = "countries/Damagaram.txt"
	
	
	MNH = "countries/Manneh.txt"
	KAB = "countries/Kaabu.txt"
	TOU = "countries/Toucouleur.txt"
	MOS = "countries/Mossi.txt"
	KAA = "countries/Kaarta.txt"
	GAO = "countries/Gao.txt"
	BAM = "countries/Bamana.txt"
	FTJ = "countries/Futa Jallon.txt"
	MSN = "countries/Massina.txt"
	FTT = "countries/Futa Toro.txt"
	SIN = "countries/Sine.txt"
	SAL = "countries/Saloum.txt"
	OYO = "countries/Oyo.txt"
	SKT = "countries/Sokoto.txt"
	DDI = "countries/Dendi.txt"
	BRG = "countries/Borgu.txt"
	HAS = "countries/Hausa Bakwai.txt"
	TOG = "countries/Togo-Be.txt"
	IJW = "countries/Ijaw.txt"
	IGA = "countries/Igala.txt"
	KAD = "countries/Kel Adagh.txt"
	
	
	TGN = "countries/Tagant.txt"
	NGA = "countries/Nigeria.txt"
	MLI = "countries/Mali.txt"
	SIE = "countries/Sierra Leone.txt"
	MRT = "countries/Mauritania.txt"
	NGR = "countries/Niger.txt"
	GHA = "countries/Ghana.txt"
	IVO = "countries/Ivory Coast.txt"
	GNA = "countries/Guinea.txt"
	GAM = "countries/Gambia.txt"

# East Africa
	# graphical_culture = african_gfx
	# graphical_culture_2d = african_2d
	COG = "countries/Congo.txt"
	ETH = "countries/Ethiopia.txt"
	KEN = "countries/Kenya.txt"
	ANG = "countries/Angola.txt"
	MED = "countries/Medri Bahri.txt"
	NKO = "countries/Nkore.txt"
	TYO = "countries/Anziku.txt"
	ARO = "countries/Aro.txt"
	ASH = "countries/Ashanti.txt"
        BUS = "countries/Busoga.txt"
	BAG = "countries/Bagirmi.txt"
	DSS = "countries/Dosso.txt"
	KDG = "countries/Kenedugu.txt"
	WAS = "countries/Wassoulou.txt"
	SRA = "countries/Sara-Kaba.txt"
	TOB = "countries/Toubou.txt"
	ADM = "countries/Adamawa.txt"
	MRN = "countries/Merina.txt"
	HRR = "countries/Harar.txt"
	AWS = "countries/Awsa.txt"
	ORO = "countries/Oromo.txt"
	SID = "countries/Sidama.txt"
	WSG = "countries/Warsangeli.txt"
	GLD = "countries/Geledi.txt"
	MAJ = "countries/Majerteen.txt"
	ZAN = "countries/Zanzibar.txt"
	MOM = "countries/Mombasa.txt"
	DFR = "countries/Darfur.txt"
	SHK = "countries/Shiluk.txt"
	BDA = "countries/Banda.txt"
	WDD = "countries/Waddai.txt"
	ALZ = "countries/Al-Zubayr.txt"
	EQA = "countries/Equatoria.txt"
	BMM = "countries/Bamum.txt"
	BET = "countries/Beti.txt"
	BLU = "countries/Bulu.txt"
	FNG = "countries/Fang.txt"
	GBG = "countries/Gbagyi.txt"
	HLO = "countries/Holo.txt"
	IJB = "countries/Ijebu.txt"
	KON = "countries/Kongo.txt"
	KTA = "countries/Kota.txt"
	KTK = "countries/Kotoko.txt"
	KUB = "countries/Kuba.txt"
	LOA = "countries/Loango.txt"
	LUB = "countries/Luba.txt"
	LUN = "countries/Lunda.txt"
	MDR = "countries/Mandara.txt"
	MSG = "countries/Mitsogo.txt"
	NGY = "countries/Ngoyo.txt"
	PUN = "countries/Punu.txt"
	YEK = "countries/Yeke.txt"
	GBY = "countries/Gbaya.txt"
	LNG = "countries/Lingala.txt"
	TEK = "countries/Teke.txt"
	RWD = "countries/Rwanda.txt"
	BUR = "countries/Burundi.txt"
	KRG = "countries/Karangwe.txt"
	BUG = "countries/Buganda.txt"
	MSI = "countries/Msiri.txt"
	TIP = "countries/Tippu Tip.txt"
	TTL = "countries/Tetala.txt"
	BKW = "countries/Bakwa Dishi.txt"
	BKM = "countries/Bukama.txt"
	NYG = "countries/Nyangwe.txt"
	TOR = "countries/Toro.txt"
	BNY = "countries/Bunyoro.txt"
	BOR = "countries/Borana Oromo.txt"
	KKY = "countries/Kikuyu.txt"
	LGR = "countries/Luguru.txt"
	LUO = "countries/Luo.txt"
	MAA = "countries/Maasai.txt"
	MMA = "countries/Meru.txt"
	NYW = "countries/Nyamwezi.txt"
	OGD = "countries/Ogaden Clan.txt"
	RDL = "countries/Rendille.txt"
	SUK = "countries/Sukuma.txt"
	TKN = "countries/Turkana.txt"
	UJJ = "countries/Ujiji.txt"
	AHR = "countries/Angolan Herero.txt"
	WYO = "countries/Wayao.txt"
	LOZ = "countries/Lozi.txt"
	BTS = "countries/Barotseland.txt"
	OVD = "countries/Ovimbundu.txt"
	CKW = "countries/Chokwe.txt"
	GGL = "countries/Ganguela.txt"
	KBD = "countries/Kimbundu.txt"
	KND = "countries/Kunda.txt"
	ZAM = "countries/Zambia.txt"
	UGA = "countries/Uganda.txt"
	NMB = "countries/Namibia.txt"
	CMR = "countries/Cameroon.txt"
	MLW = "countries/Malawi.txt"
	CAR = "countries/Central African Republic.txt"
	SOM = "countries/Somalia.txt"
	CEK = "countries/CopticEthiopianKingdom.txt"
	ZAI = "countries/Zaire.txt"
	SUD = "countries/Sudan.txt"
	SSD = "countries/South Sudan.txt"
	KKO = "countries/Kakongo.txt"
	GAB = "countries/Gabon.txt"
	RCG = "countries/Republic of Congo.txt"
	TGY = "countries/Tanganyika.txt"
	CHA = "countries/Chad.txt"
 
# Southern Africa
	# graphical_culture = african_gfx
	# graphical_culture_2d = african_2d
	BOT = "countries/Botswana.txt"
	OFS = "countries/Orange.txt"
	SAF = "countries/South Africa.txt"
	TRV = "countries/Transvaal.txt"
	ZUL = "countries/Zululand.txt"
	SOT = "countries/Sotho.txt"
	MZB = "countries/Mozambique.txt"
	HER = "countries/Herero.txt"
	OOR = "countries/Oorlam.txt"
	BST = "countries/Baster.txt"
	HMB = "countries/Himba.txt"
	KVG = "countries/Kavango.txt"
	OVB = "countries/Ovambo.txt"
	ROZ = "countries/Rozwi.txt"
	BAT = "countries/Batswana.txt"
	#BMG = "countries/Bamangwato.txt"
	NDE = "countries/Ndebele.txt"
	SAA = "countries/Saan.txt"
	#BNG = "countries/Bangwaketse.txt"
	SWZ = "countries/Swaziland.txt"
	NAT = "countries/Natal.txt"
	GQW = "countries/Griqualand West.txt"
	GQE = "countries/Griqualand East.txt"
	STL = "countries/Stellaland.txt"
	GOS = "countries/Goshen.txt"
	NIR = "countries/Nieuwe Republiek.txt"
	GAZ = "countries/Gaza Empire.txt"
	RHO = "countries/Rhodesia.txt"
	ZIM = "countries/Zimbabwe.txt"